10001000
11001000
11000000
11100000
10111000
11101000
10000000
11111111
